31811181811111811111111811111811111111111811111111811118111111118111111181111118111118111111111111111181111811181114
20200020200000200000000200000200000000000200000000200002000000002000000020000002000002000000000000000020000200020002
20202020201110202011810202020003111103111b11111020203102031181102011181020111102011102011111118111811020310002000202
20202020200000202000200516091116000002000200000020202002020020002000020020000002000002000000002000200020200317111602
200020202020316020200000000200000202000202020111a020201600000020002000016020111710020511111401a020002000200200000002
911160202020200020510311140201111b1711160202000020000000011111b1116020000020000000020000000200205111b14051020111111a
20000000002000200000020002020000020000000205111020111140000000200000201111711111110201111105102000002020000000000002
2011811111b111603601160200000310020118110200000020000020000000201111600000000000000000000000000000202020310203111402
200020000020000020000009111102000200020002011811601111b1111110200000003111111140311111181031111181a02000200202000202
20202018102011116011111600000203160202011600020000000020000000201811102000000020200000020020000020200011711602020002
2020200200200000000000000020000200020000000202020000002011111160020000201140202020111102016011400020200000000205111a
20202000036031111011111111711102011711020116020511111020000000000002016000202020200000000000002011602011118102000002
202091011a0020000000000000000002000000020000020000000020111111111402000020002000511111020111102000002000002005181102
202020000203601111111401111140360111111a0140160118111160000000000205181051117100000000020000005111117102002000020002
2000203102020000000002000000202000000002002000000200000001118111020002000000000011111117181020000000000201b11402011a
9111b1600205111114011b1111102051111031020160111402000002000020000203160118111110000000000200202002002002002002020002
2000200036000000020002000000200000002000000000020200200200002011160200000200000011114011020360201710511a002000000202
2020201160011402000000011111711101116011110111020000201602002000000202020202020000002000020511600000000200202020171a
2020200000000209111020000000000000000000000000000111a000020000200000020200020200202051111a0000002018111b117160200002
20202020020002020000511140111111020111110200311000002011160110201403171711020511a0202000051402016002000200000051111a
20202051171100000000000020000000020000000200200002000000000000200202000000020000202020000002020000000200000020000002
20202000000003111103111020111400000140201601711117110310111401710202020111020140202020181036051102011714011160311102
20000031102002000002000000000201140020200000000000000200000200000200020000020020200020091020000002000002000000200002
9101116000540201111602011111020002016020111111111111020111020111171117111117109171017116005140111602011a011111a0111a
20000000200002000000020000000200020000200000000000000200000200000000000000000020000000000000200000020002000000200002
51111111711117111111171111111711171111711111111111111711111711111111111111111171111111111111711111171117111111711106